//MAP CONVERTED BY dmm2tgm.py THIS HEADER COMMENT PREVENTS RECONVERSION, DO NOT REMOVE
"a" = (
)
"b" = (
/obj/structure/closet/secure_closet/medical3,
/turf/open/floor/plasteel/white,
/area/space)
"d" = (
/obj/structure/table/glass,
/obj/item/wrench,
/turf/open/floor/plasteel,
/area/space)
"e" = (
/turf/open/floor/plasteel,
/area/space)
"g" = (
/obj/effect/turf_decal/bot,
/obj/machinery/vending/hydroseeds{
	default_price = 0;
	extra_price = 0;
	fair_market_price = 0
	},
/turf/open/floor/plasteel,
/area/space)
"h" = (
/obj/machinery/smartfridge/organ,
/turf/open/floor/plasteel/white,
/area/space)
"j" = (
/obj/structure/table/glass,
/obj/item/geneshears,
/turf/open/floor/plasteel,
/area/space)
"k" = (
/obj/structure/table/glass,
/obj/item/storage/firstaid/o2{
	pixel_x = 6;
	pixel_y = 6
	},
/obj/item/storage/firstaid/o2{
	pixel_x = 3;
	pixel_y = 3
	},
/obj/item/storage/firstaid/regular,
/obj/item/storage/firstaid/o2{
	pixel_x = -3;
	pixel_y = -3
	},
/obj/machinery/door/window/westleft{
	name = "First-Aid Supplies";
	red_alert_access = 1;
	req_access_txt = "5"
	},
/obj/effect/turf_decal/tile/neutral{
	dir = 1
	},
/obj/effect/turf_decal/tile/neutral{
	dir = 8
	},
/turf/open/floor/plasteel{
	heat_capacity = 1e+006
	},
/area/space)
"l" = (
/obj/machinery/stasis,
/obj/machinery/computer/operating,
/obj/item/disk/surgery,
/turf/open/floor/plasteel/white,
/area/space)
"n" = (
/obj/structure/reagent_dispensers/watertank,
/obj/item/reagent_containers/glass/bucket,
/turf/open/floor/plasteel,
/area/space)
"o" = (
/obj/machinery/chem_dispenser,
/turf/open/floor/plasteel/white,
/area/space)
"p" = (
/obj/structure/table,
/obj/machinery/reagentgrinder,
/obj/item/stack/sheet/mineral/plasma{
	pixel_y = 10
	},
/obj/item/radio/intercom{
	pixel_y = -28
	},
/obj/effect/turf_decal/tile/yellow,
/obj/effect/turf_decal/tile/yellow{
	dir = 8
	},
/turf/open/floor/plasteel/white,
/area/space)
"q" = (
/obj/structure/table/glass,
/obj/machinery/reagentgrinder{
	pixel_y = 5
	},
/obj/item/reagent_containers/glass/beaker/large,
/turf/open/floor/plasteel/white,
/area/space)
"r" = (
/obj/structure/table/glass,
/obj/item/storage/box/beakers{
	pixel_x = 3;
	pixel_y = 3
	},
/obj/item/storage/box/syringes,
/obj/item/gun/syringe,
/obj/structure/window/reinforced,
/obj/structure/window/reinforced{
	dir = 4
	},
/obj/effect/turf_decal/tile/neutral,
/obj/effect/turf_decal/tile/neutral{
	dir = 4
	},
/turf/open/floor/plasteel,
/area/space)
"s" = (
/obj/machinery/door/airlock/medical/glass,
/turf/open/floor/plasteel,
/area/space)
"u" = (
/obj/structure/table,
/obj/item/stack/ducts/fifty,
/obj/item/stack/ducts/fifty,
/obj/item/stack/ducts/fifty,
/obj/item/stack/ducts/fifty,
/obj/item/stack/ducts/fifty,
/obj/item/stack/ducts/fifty,
/obj/item/stack/ducts/fifty,
/obj/item/stack/ducts/fifty,
/obj/item/plunger,
/obj/item/plunger,
/obj/machinery/camera/autoname{
	dir = 1
	},
/obj/item/radio/intercom{
	pixel_x = -26
	},
/obj/machinery/requests_console{
	department = "Chemistry Lab";
	name = "Chemistry RC";
	pixel_y = -32;
	receive_ore_updates = 1
	},
/obj/effect/turf_decal/tile/yellow{
	dir = 1
	},
/obj/effect/turf_decal/tile/yellow{
	dir = 8
	},
/obj/effect/turf_decal/tile/yellow,
/turf/open/floor/plasteel/white,
/area/space)
"v" = (
/obj/machinery/computer/operating,
/obj/item/disk/surgery,
/turf/open/floor/plasteel/white,
/area/space)
"w" = (
/obj/structure/table,
/obj/item/stack/sheet/metal/fifty,
/obj/item/stack/sheet/metal/fifty,
/obj/item/construction/plumbing,
/obj/item/construction/plumbing,
/obj/machinery/light,
/obj/effect/turf_decal/trimline/yellow/filled/corner,
/turf/open/floor/plasteel/white,
/area/space)
"x" = (
/obj/structure/table/glass,
/obj/item/storage/firstaid/toxin{
	pixel_x = 6;
	pixel_y = 6
	},
/obj/item/storage/firstaid/toxin{
	pixel_x = 3;
	pixel_y = 3
	},
/obj/item/storage/firstaid/regular,
/obj/item/storage/firstaid/toxin{
	pixel_x = -3;
	pixel_y = -3
	},
/obj/machinery/light{
	dir = 4
	},
/obj/structure/window/reinforced{
	dir = 1
	},
/obj/structure/window/reinforced{
	dir = 8
	},
/obj/effect/turf_decal/tile/neutral{
	dir = 1
	},
/obj/effect/turf_decal/tile/neutral{
	dir = 8
	},
/turf/open/floor/plasteel{
	heat_capacity = 1e+006
	},
/area/space)
"y" = (
/turf/open/floor/plasteel/white,
/area/space)
"z" = (
/obj/structure/table/glass,
/obj/item/storage/box/beakers,
/obj/item/reagent_containers/dropper,
/obj/item/stack/sheet/mineral/plasma,
/turf/open/floor/plasteel/white,
/area/space)
"B" = (
/obj/structure/sink{
	dir = 8;
	pixel_x = 11
	},
/turf/open/floor/plasteel,
/area/space)
"C" = (
/obj/structure/table,
/obj/item/storage/toolbox/mechanical,
/obj/item/clothing/head/welding,
/obj/effect/turf_decal/tile/yellow{
	dir = 8
	},
/obj/effect/turf_decal/tile/yellow{
	dir = 1
	},
/turf/open/floor/plasteel/white,
/area/space)
"D" = (
/obj/machinery/smartfridge/chemistry,
/turf/open/floor/plasteel/white,
/area/space)
"E" = (
/obj/machinery/vending/medical,
/turf/open/floor/plasteel/white,
/area/space)
"F" = (
/obj/structure/table/glass,
/obj/item/storage/firstaid/brute{
	pixel_x = 6;
	pixel_y = 6
	},
/obj/item/storage/firstaid/brute{
	pixel_x = 3;
	pixel_y = 3
	},
/obj/item/storage/firstaid/regular,
/obj/item/storage/firstaid/brute{
	pixel_x = -3;
	pixel_y = -3
	},
/obj/machinery/door/window/eastleft{
	name = "First-Aid Supplies";
	red_alert_access = 1;
	req_access_txt = "5"
	},
/obj/effect/turf_decal/tile/neutral,
/obj/effect/turf_decal/tile/neutral{
	dir = 4
	},
/turf/open/floor/plasteel,
/area/space)
"G" = (
/obj/structure/table/glass,
/obj/item/storage/belt/medical,
/obj/item/storage/belt/medical,
/obj/item/clothing/neck/stethoscope,
/obj/item/clothing/neck/stethoscope,
/obj/item/clothing/glasses/hud/health,
/obj/item/clothing/glasses/hud/health,
/obj/structure/window/reinforced,
/obj/structure/window/reinforced{
	dir = 8
	},
/obj/item/clothing/glasses/hud/health,
/obj/item/clothing/glasses/hud/health,
/obj/item/clothing/glasses/hud/health,
/obj/item/clothing/glasses/hud/health,
/obj/item/clothing/glasses/hud/health,
/obj/item/reagent_containers/spray/cleaner{
	pixel_x = -3;
	pixel_y = 2
	},
/obj/effect/turf_decal/tile/neutral{
	dir = 1
	},
/obj/effect/turf_decal/tile/neutral{
	dir = 8
	},
/turf/open/floor/plasteel{
	heat_capacity = 1e+006
	},
/area/space)
"I" = (
/obj/machinery/vending/wardrobe/hydro_wardrobe,
/turf/open/floor/plasteel,
/area/space)
"J" = (
/obj/machinery/stasis,
/turf/open/floor/plasteel/white,
/area/space)
"K" = (
/obj/effect/turf_decal/tile/yellow{
	dir = 1
	},
/obj/effect/turf_decal/tile/yellow,
/turf/open/floor/plasteel/white,
/area/space)
"M" = (
/obj/machinery/chem_master,
/turf/open/floor/plasteel/white,
/area/space)
"N" = (
/obj/structure/table/glass,
/obj/item/storage/firstaid/fire{
	pixel_x = 6;
	pixel_y = 6
	},
/obj/item/storage/firstaid/fire{
	pixel_x = 3;
	pixel_y = 3
	},
/obj/item/storage/firstaid/regular,
/obj/item/storage/firstaid/fire{
	pixel_x = -3;
	pixel_y = -3
	},
/obj/structure/window/reinforced{
	dir = 1
	},
/obj/structure/window/reinforced{
	dir = 4
	},
/obj/effect/turf_decal/tile/neutral,
/obj/effect/turf_decal/tile/neutral{
	dir = 4
	},
/turf/open/floor/plasteel,
/area/space)
"O" = (
/obj/effect/turf_decal/bot,
/obj/machinery/vending/hydronutrients{
	default_price = 0;
	extra_price = 0;
	fair_market_price = 0
	},
/turf/open/floor/plasteel,
/area/space)
"P" = (
/obj/machinery/shower{
	dir = 4
	},
/turf/open/floor/plasteel/white,
/area/space)
"Q" = (
/obj/structure/closet/secure_closet/hydroponics,
/turf/open/floor/plasteel,
/area/space)
"R" = (
/obj/machinery/biogenerator,
/turf/open/floor/plasteel,
/area/space)
"S" = (
/obj/machinery/hydroponics/constructable,
/obj/machinery/light{
	dir = 8
	},
/obj/effect/turf_decal/delivery,
/turf/open/floor/plasteel,
/area/space)
"T" = (
/turf/closed/wall,
/area/space)
"U" = (
/obj/structure/bodycontainer/morgue{
	dir = 2
	},
/turf/open/floor/plasteel/white,
/area/space)
"V" = (
/obj/machinery/hydroponics/constructable,
/obj/effect/turf_decal/delivery,
/turf/open/floor/plasteel,
/area/space)
"W" = (
/obj/structure/table/abductor,
/turf/open/floor/plasteel/white,
/area/space)
"X" = (
/obj/machinery/vending/wardrobe/medi_wardrobe,
/turf/open/floor/plasteel,
/area/space)
"Y" = (
/obj/structure/table/glass,
/obj/item/gun/energy/floragun{
	pixel_y = 5
	},
/obj/item/gun/energy/floragun,
/turf/open/floor/plasteel,
/area/space)
"Z" = (
/obj/structure/table/optable,
/obj/item/storage/backpack/duffelbag/med/surgery,
/turf/open/floor/plasteel/white,
/area/space)

(1,1,1) = {"
T
T
T
T
T
T
T
T
T
T
T
T
T
T
T
T
T
T
T
T
T
T
T
T
T
T
T
T
T
T
T
T
T
T
T
T
T
T
T
T
T
T
T
T
T
T
T
T
T
T
T
T
T
T
T
T
T
T
T
T
T
T
T
a
"}
(2,1,1) = {"
T
v
y
P
N
F
r
C
u
T
e
e
e
e
e
e
e
e
e
e
e
e
e
e
e
e
e
e
e
e
e
e
e
e
e
e
e
e
e
e
e
e
e
e
e
e
e
e
e
e
e
e
e
e
e
e
e
e
e
e
e
e
e
T
"}
(3,1,1) = {"
T
Z
y
y
y
y
y
K
p
T
e
e
e
e
e
e
e
e
e
e
e
e
e
e
e
e
e
e
e
e
e
e
e
e
e
e
e
e
e
e
e
e
e
e
e
e
e
e
e
e
e
e
e
e
e
e
e
e
e
e
e
e
e
T
"}
(4,1,1) = {"
T
J
y
y
y
y
y
y
w
T
e
e
e
e
e
e
e
e
e
e
e
e
e
e
e
e
e
e
e
e
e
e
e
e
e
e
e
e
e
e
e
e
e
e
e
e
e
e
e
e
e
e
e
e
e
e
e
e
e
e
e
e
e
T
"}
(5,1,1) = {"
T
l
y
y
y
y
y
y
y
T
e
e
e
e
e
e
e
e
e
e
e
e
e
e
e
e
e
e
e
e
e
e
e
e
e
e
e
e
e
e
e
e
e
e
e
e
e
e
e
e
e
e
e
e
e
e
e
e
e
e
e
e
e
T
"}
(6,1,1) = {"
T
h
y
y
y
y
y
y
b
T
X
e
e
e
e
e
e
e
e
e
e
e
e
e
e
e
e
e
e
e
e
e
e
e
e
e
e
e
e
e
e
e
e
e
e
e
e
e
e
e
e
e
e
e
e
e
e
e
e
e
e
e
e
T
"}
(7,1,1) = {"
T
U
y
y
W
y
y
y
y
s
e
e
e
e
e
e
e
e
e
e
e
e
e
e
e
e
e
e
e
e
e
e
e
e
e
e
e
e
e
e
e
e
e
e
e
e
e
e
e
e
e
e
e
e
e
e
e
e
e
e
e
e
e
T
"}
(8,1,1) = {"
T
D
y
y
y
y
y
y
b
T
X
e
e
e
e
e
e
e
e
e
e
e
e
e
e
e
e
e
e
e
e
e
e
e
e
e
e
e
e
e
e
e
e
e
e
e
e
e
e
e
e
e
e
e
e
e
e
e
e
e
e
e
e
T
"}
(9,1,1) = {"
T
M
y
y
y
y
y
y
E
T
e
e
e
e
e
e
e
e
e
e
e
e
e
e
e
e
e
e
e
e
e
e
e
e
e
e
e
e
e
e
e
e
e
e
e
e
e
e
e
e
e
e
e
e
e
e
e
e
e
e
e
e
e
T
"}
(10,1,1) = {"
T
q
y
y
y
y
y
y
y
T
e
e
e
e
e
e
e
e
e
e
e
e
e
e
e
e
e
e
e
e
e
e
e
e
e
e
e
e
e
e
e
e
e
e
e
e
e
e
e
e
e
e
e
e
e
e
e
e
e
e
e
e
e
T
"}
(11,1,1) = {"
T
z
y
y
y
y
y
y
y
T
e
e
e
e
e
e
e
e
e
e
e
e
e
e
e
e
e
e
e
e
e
e
e
e
e
e
e
e
e
e
e
e
e
e
e
e
e
e
e
e
e
e
e
e
e
e
e
e
e
e
e
e
e
T
"}
(12,1,1) = {"
T
o
y
y
x
k
G
y
y
T
e
e
e
e
e
e
e
e
e
e
e
e
e
e
e
e
e
e
e
e
e
e
e
e
e
e
e
e
e
e
e
e
e
e
e
e
e
e
e
e
e
e
e
e
e
e
e
e
e
e
e
e
e
T
"}
(13,1,1) = {"
T
T
T
T
T
T
T
T
T
T
e
e
e
e
e
e
e
e
e
e
e
e
e
e
e
e
e
e
e
e
e
e
e
e
e
e
e
e
e
e
e
e
e
e
e
e
e
e
e
e
e
e
e
e
e
e
e
e
e
e
e
e
e
T
"}
(14,1,1) = {"
T
e
V
S
V
V
S
V
e
T
e
e
e
e
e
e
e
e
e
e
e
e
e
e
e
e
e
e
e
e
e
e
e
e
e
e
e
e
e
e
e
e
e
e
e
e
e
e
e
e
e
e
e
e
e
e
e
e
e
e
e
e
e
T
"}
(15,1,1) = {"
T
e
e
e
e
e
e
e
e
T
e
e
e
e
e
e
e
e
e
e
e
e
e
e
e
e
e
e
e
e
e
e
e
e
e
e
e
e
e
e
e
e
e
e
e
e
e
e
e
e
e
e
e
e
e
e
e
e
e
e
e
e
e
T
"}
(16,1,1) = {"
T
e
V
V
V
V
V
V
e
T
e
e
e
e
e
e
e
e
e
e
e
e
e
e
e
e
e
e
e
e
e
e
e
e
e
e
e
e
e
e
e
e
e
e
e
e
e
e
e
e
e
e
e
e
e
e
e
e
e
e
e
e
e
T
"}
(17,1,1) = {"
T
e
e
e
e
e
e
e
e
T
e
e
e
e
e
e
e
e
e
e
e
e
e
e
e
e
e
e
e
e
e
e
e
e
e
e
e
e
e
e
e
e
e
e
e
e
e
e
e
e
e
e
e
e
e
e
e
e
e
e
e
e
e
T
"}
(18,1,1) = {"
T
e
V
V
V
V
V
V
e
T
I
e
e
e
e
e
e
e
e
e
e
e
e
e
e
e
e
e
e
e
e
e
e
e
e
e
e
e
e
e
e
e
e
e
e
e
e
e
e
e
e
e
e
e
e
e
e
e
e
e
e
e
e
T
"}
(19,1,1) = {"
T
e
e
e
e
e
e
e
e
s
e
e
e
e
e
e
e
e
e
e
e
e
e
e
e
e
e
e
e
e
e
e
e
e
e
e
e
e
e
e
e
e
e
e
e
e
e
e
e
e
e
e
e
e
e
e
e
e
e
e
e
e
e
T
"}
(20,1,1) = {"
T
e
e
e
e
e
e
e
e
T
I
e
e
e
e
e
e
e
e
e
e
e
e
e
e
e
e
e
e
e
e
e
e
e
e
e
e
e
e
e
e
e
e
e
e
e
e
e
e
e
e
e
e
e
e
e
e
e
e
e
e
e
e
T
"}
(21,1,1) = {"
T
g
e
e
e
e
e
e
e
T
e
e
e
e
e
e
e
e
e
e
e
e
e
e
e
e
e
e
e
e
e
e
e
e
e
e
e
e
e
e
e
e
e
e
e
e
e
e
e
e
e
e
e
e
e
e
e
e
e
e
e
e
e
T
"}
(22,1,1) = {"
T
g
e
e
e
e
e
e
e
T
e
e
e
e
e
e
e
e
e
e
e
e
e
e
e
e
e
e
e
e
e
e
e
e
e
e
e
e
e
e
e
e
e
e
e
e
e
e
e
e
e
e
e
e
e
e
e
e
e
e
e
e
e
T
"}
(23,1,1) = {"
T
O
e
e
e
e
e
e
Y
T
e
e
e
e
e
e
e
e
e
e
e
e
e
e
e
e
e
e
e
e
e
e
e
e
e
e
e
e
e
e
e
e
e
e
e
e
e
e
e
e
e
e
e
e
e
e
e
e
e
e
e
e
e
T
"}
(24,1,1) = {"
T
O
B
Q
n
n
R
d
j
T
e
e
e
e
e
e
e
e
e
e
e
e
e
e
e
e
e
e
e
e
e
e
e
e
e
e
e
e
e
e
e
e
e
e
e
e
e
e
e
e
e
e
e
e
e
e
e
e
e
e
e
e
e
T
"}
(25,1,1) = {"
T
T
T
T
T
T
T
T
T
T
e
e
e
e
e
e
e
e
e
e
e
e
e
e
e
e
e
e
e
e
e
e
e
e
e
e
e
e
e
e
e
e
e
e
e
e
e
e
e
e
e
e
e
e
e
e
e
e
e
e
e
e
e
T
"}
(26,1,1) = {"
T
e
e
e
e
e
e
e
e
e
e
e
e
e
e
e
e
e
e
e
e
e
e
e
e
e
e
e
e
e
e
e
e
e
e
e
e
e
e
e
e
e
e
e
e
e
e
e
e
e
e
e
e
e
e
e
e
e
e
e
e
e
e
T
"}
(27,1,1) = {"
T
e
e
e
e
e
e
e
e
e
e
e
e
e
e
e
e
e
e
e
e
e
e
e
e
e
e
e
e
e
e
e
e
e
e
e
e
e
e
e
e
e
e
e
e
e
e
e
e
e
e
e
e
e
e
e
e
e
e
e
e
e
e
T
"}
(28,1,1) = {"
T
e
e
e
e
e
e
e
e
e
e
e
e
e
e
e
e
e
e
e
e
e
e
e
e
e
e
e
e
e
e
e
e
e
e
e
e
e
e
e
e
e
e
e
e
e
e
e
e
e
e
e
e
e
e
e
e
e
e
e
e
e
e
T
"}
(29,1,1) = {"
T
e
e
e
e
e
e
e
e
e
e
e
e
e
e
e
e
e
e
e
e
e
e
e
e
e
e
e
e
e
e
e
e
e
e
e
e
e
e
e
e
e
e
e
e
e
e
e
e
e
e
e
e
e
e
e
e
e
e
e
e
e
e
T
"}
(30,1,1) = {"
T
e
e
e
e
e
e
e
e
e
e
e
e
e
e
e
e
e
e
e
e
e
e
e
e
e
e
e
e
e
e
e
e
e
e
e
e
e
e
e
e
e
e
e
e
e
e
e
e
e
e
e
e
e
e
e
e
e
e
e
e
e
e
T
"}
(31,1,1) = {"
T
e
e
e
e
e
e
e
e
e
e
e
e
e
e
e
e
e
e
e
e
e
e
e
e
e
e
e
e
e
e
e
e
e
e
e
e
e
e
e
e
e
e
e
e
e
e
e
e
e
e
e
e
e
e
e
e
e
e
e
e
e
e
T
"}
(32,1,1) = {"
T
e
e
e
e
e
e
e
e
e
e
e
e
e
e
e
e
e
e
e
e
e
e
e
e
e
e
e
e
e
e
e
e
e
e
e
e
e
e
e
e
e
e
e
e
e
e
e
e
e
e
e
e
e
e
e
e
e
e
e
e
e
e
T
"}
(33,1,1) = {"
T
e
e
e
e
e
e
e
e
e
e
e
e
e
e
e
e
e
e
e
e
e
e
e
e
e
e
e
e
e
e
e
e
e
e
e
e
e
e
e
e
e
e
e
e
e
e
e
e
e
e
e
e
e
e
e
e
e
e
e
e
e
e
T
"}
(34,1,1) = {"
T
e
e
e
e
e
e
e
e
e
e
e
e
e
e
e
e
e
e
e
e
e
e
e
e
e
e
e
e
e
e
e
e
e
e
e
e
e
e
e
e
e
e
e
e
e
e
e
e
e
e
e
e
e
e
e
e
e
e
e
e
e
e
T
"}
(35,1,1) = {"
T
e
e
e
e
e
e
e
e
e
e
e
e
e
e
e
e
e
e
e
e
e
e
e
e
e
e
e
e
e
e
e
e
e
e
e
e
e
e
e
e
e
e
e
e
e
e
e
e
e
e
e
e
e
e
e
e
e
e
e
e
e
e
T
"}
(36,1,1) = {"
T
e
e
e
e
e
e
e
e
e
e
e
e
e
e
e
e
e
e
e
e
e
e
e
e
e
e
e
e
e
e
e
e
e
e
e
e
e
e
e
e
e
e
e
e
e
e
e
e
e
e
e
e
e
e
e
e
e
e
e
e
e
e
T
"}
(37,1,1) = {"
T
e
e
e
e
e
e
e
e
e
e
e
e
e
e
e
e
e
e
e
e
e
e
e
e
e
e
e
e
e
e
e
e
e
e
e
e
e
e
e
e
e
e
e
e
e
e
e
e
e
e
e
e
e
e
e
e
e
e
e
e
e
e
T
"}
(38,1,1) = {"
T
e
e
e
e
e
e
e
e
e
e
e
e
e
e
e
e
e
e
e
e
e
e
e
e
e
e
e
e
e
e
e
e
e
e
e
e
e
e
e
e
e
e
e
e
e
e
e
e
e
e
e
e
e
e
e
e
e
e
e
e
e
e
T
"}
(39,1,1) = {"
T
e
e
e
e
e
e
e
e
e
e
e
e
e
e
e
e
e
e
e
e
e
e
e
e
e
e
e
e
e
e
e
e
e
e
e
e
e
e
e
e
e
e
e
e
e
e
e
e
e
e
e
e
e
e
e
e
e
e
e
e
e
e
T
"}
(40,1,1) = {"
T
e
e
e
e
e
e
e
e
e
e
e
e
e
e
e
e
e
e
e
e
e
e
e
e
e
e
e
e
e
e
e
e
e
e
e
e
e
e
e
e
e
e
e
e
e
e
e
e
e
e
e
e
e
e
e
e
e
e
e
e
e
e
T
"}
(41,1,1) = {"
T
e
e
e
e
e
e
e
e
e
e
e
e
e
e
e
e
e
e
e
e
e
e
e
e
e
e
e
e
e
e
e
e
e
e
e
e
e
e
e
e
e
e
e
e
e
e
e
e
e
e
e
e
e
e
e
e
e
e
e
e
e
e
T
"}
(42,1,1) = {"
T
e
e
e
e
e
e
e
e
e
e
e
e
e
e
e
e
e
e
e
e
e
e
e
e
e
e
e
e
e
e
e
e
e
e
e
e
e
e
e
e
e
e
e
e
e
e
e
e
e
e
e
e
e
e
e
e
e
e
e
e
e
e
T
"}
(43,1,1) = {"
T
e
e
e
e
e
e
e
e
e
e
e
e
e
e
e
e
e
e
e
e
e
e
e
e
e
e
e
e
e
e
e
e
e
e
e
e
e
e
e
e
e
e
e
e
e
e
e
e
e
e
e
e
e
e
e
e
e
e
e
e
e
e
T
"}
(44,1,1) = {"
T
e
e
e
e
e
e
e
e
e
e
e
e
e
e
e
e
e
e
e
e
e
e
e
e
e
e
e
e
e
e
e
e
e
e
e
e
e
e
e
e
e
e
e
e
e
e
e
e
e
e
e
e
e
e
e
e
e
e
e
e
e
e
T
"}
(45,1,1) = {"
T
e
e
e
e
e
e
e
e
e
e
e
e
e
e
e
e
e
e
e
e
e
e
e
e
e
e
e
e
e
e
e
e
e
e
e
e
e
e
e
e
e
e
e
e
e
e
e
e
e
e
e
e
e
e
e
e
e
e
e
e
e
e
T
"}
(46,1,1) = {"
T
e
e
e
e
e
e
e
e
e
e
e
e
e
e
e
e
e
e
e
e
e
e
e
e
e
e
e
e
e
e
e
e
e
e
e
e
e
e
e
e
e
e
e
e
e
e
e
e
e
e
e
e
e
e
e
e
e
e
e
e
e
e
T
"}
(47,1,1) = {"
T
e
e
e
e
e
e
e
e
e
e
e
e
e
e
e
e
e
e
e
e
e
e
e
e
e
e
e
e
e
e
e
e
e
e
e
e
e
e
e
e
e
e
e
e
e
e
e
e
e
e
e
e
e
e
e
e
e
e
e
e
e
e
T
"}
(48,1,1) = {"
T
e
e
e
e
e
e
e
e
e
e
e
e
e
e
e
e
e
e
e
e
e
e
e
e
e
e
e
e
e
e
e
e
e
e
e
e
e
e
e
e
e
e
e
e
e
e
e
e
e
e
e
e
e
e
e
e
e
e
e
e
e
e
T
"}
(49,1,1) = {"
T
e
e
e
e
e
e
e
e
e
e
e
e
e
e
e
e
e
e
e
e
e
e
e
e
e
e
e
e
e
e
e
e
e
e
e
e
e
e
e
e
e
e
e
e
e
e
e
e
e
e
e
e
e
e
e
e
e
e
e
e
e
e
T
"}
(50,1,1) = {"
T
e
e
e
e
e
e
e
e
e
e
e
e
e
e
e
e
e
e
e
e
e
e
e
e
e
e
e
e
e
e
e
e
e
e
e
e
e
e
e
e
e
e
e
e
e
e
e
e
e
e
e
e
e
e
e
e
e
e
e
e
e
e
T
"}
(51,1,1) = {"
T
e
e
e
e
e
e
e
e
e
e
e
e
e
e
e
e
e
e
e
e
e
e
e
e
e
e
e
e
e
e
e
e
e
e
e
e
e
e
e
e
e
e
e
e
e
e
e
e
e
e
e
e
e
e
e
e
e
e
e
e
e
e
T
"}
(52,1,1) = {"
T
e
e
e
e
e
e
e
e
e
e
e
e
e
e
e
e
e
e
e
e
e
e
e
e
e
e
e
e
e
e
e
e
e
e
e
e
e
e
e
e
e
e
e
e
e
e
e
e
e
e
e
e
e
e
e
e
e
e
e
e
e
e
T
"}
(53,1,1) = {"
T
e
e
e
e
e
e
e
e
e
e
e
e
e
e
e
e
e
e
e
e
e
e
e
e
e
e
e
e
e
e
e
e
e
e
e
e
e
e
e
e
e
e
e
e
e
e
e
e
e
e
e
e
e
e
e
e
e
e
e
e
e
e
T
"}
(54,1,1) = {"
T
e
e
e
e
e
e
e
e
e
e
e
e
e
e
e
e
e
e
e
e
e
e
e
e
e
e
e
e
e
e
e
e
e
e
e
e
e
e
e
e
e
e
e
e
e
e
e
e
e
e
e
e
e
e
e
e
e
e
e
e
e
e
T
"}
(55,1,1) = {"
T
e
e
e
e
e
e
e
e
e
e
e
e
e
e
e
e
e
e
e
e
e
e
e
e
e
e
e
e
e
e
e
e
e
e
e
e
e
e
e
e
e
e
e
e
e
e
e
e
e
e
e
e
e
e
e
e
e
e
e
e
e
e
T
"}
(56,1,1) = {"
T
e
e
e
e
e
e
e
e
e
e
e
e
e
e
e
e
e
e
e
e
e
e
e
e
e
e
e
e
e
e
e
e
e
e
e
e
e
e
e
e
e
e
e
e
e
e
e
e
e
e
e
e
e
e
e
e
e
e
e
e
e
e
T
"}
(57,1,1) = {"
T
e
e
e
e
e
e
e
e
e
e
e
e
e
e
e
e
e
e
e
e
e
e
e
e
e
e
e
e
e
e
e
e
e
e
e
e
e
e
e
e
e
e
e
e
e
e
e
e
e
e
e
e
e
e
e
e
e
e
e
e
e
e
T
"}
(58,1,1) = {"
T
e
e
e
e
e
e
e
e
e
e
e
e
e
e
e
e
e
e
e
e
e
e
e
e
e
e
e
e
e
e
e
e
e
e
e
e
e
e
e
e
e
e
e
e
e
e
e
e
e
e
e
e
e
e
e
e
e
e
e
e
e
e
T
"}
(59,1,1) = {"
T
e
e
e
e
e
e
e
e
e
e
e
e
e
e
e
e
e
e
e
e
e
e
e
e
e
e
e
e
e
e
e
e
e
e
e
e
e
e
e
e
e
e
e
e
e
e
e
e
e
e
e
e
e
e
e
e
e
e
e
e
e
e
T
"}
(60,1,1) = {"
T
e
e
e
e
e
e
e
e
e
e
e
e
e
e
e
e
e
e
e
e
e
e
e
e
e
e
e
e
e
e
e
e
e
e
e
e
e
e
e
e
e
e
e
e
e
e
e
e
e
e
e
e
e
e
e
e
e
e
e
e
e
e
T
"}
(61,1,1) = {"
T
e
e
e
e
e
e
e
e
e
e
e
e
e
e
e
e
e
e
e
e
e
e
e
e
e
e
e
e
e
e
e
e
e
e
e
e
e
e
e
e
e
e
e
e
e
e
e
e
e
e
e
e
e
e
e
e
e
e
e
e
e
e
T
"}
(62,1,1) = {"
T
e
e
e
e
e
e
e
e
e
e
e
e
e
e
e
e
e
e
e
e
e
e
e
e
e
e
e
e
e
e
e
e
e
e
e
e
e
e
e
e
e
e
e
e
e
e
e
e
e
e
e
e
e
e
e
e
e
e
e
e
e
e
T
"}
(63,1,1) = {"
T
e
e
e
e
e
e
e
e
e
e
e
e
e
e
e
e
e
e
e
e
e
e
e
e
e
e
e
e
e
e
e
e
e
e
e
e
e
e
e
e
e
e
e
e
e
e
e
e
e
e
e
e
e
e
e
e
e
e
e
e
e
e
T
"}
(64,1,1) = {"
T
T
T
T
T
T
T
T
T
T
T
T
T
T
T
T
T
T
T
T
T
T
T
T
T
T
T
T
T
T
T
T
T
T
T
T
T
T
T
T
T
T
T
T
T
T
T
T
T
T
T
T
T
T
T
T
T
T
T
T
T
T
T
T
"}
